[-1,	-1,	-1,	-1,	30,	29,	28,	27,	28,	29,	30,	-1,	-1,	-1,	-1],
[-1,	-1,	26,	25,	24,	23,	22,	21,	22,	23,	24,	25,	26,	-1,	-1],
[-1,	26,	20,	19,	18,	17,	16,	15,	16,	17,	18,	19,	20,	26,	-1],
[-1,	25,	19,	14,	13,	12,	11,	10,	11,	12,	13,	14,	19,	25,	-1],
[30,	24,	18,	13,	 9,	 8,	 7,	 6,	 7,	 8,	9,	13,	18,	24,	30],
[29,	23,	17,	12,	 8,	 5,	 4,	 3,	 4,	 5,	8,	12,	17,	23,	29],
[28,	22,	16,	11,	 7,	 4,	 2,	 1,	 2,	 4,	7,	11,	16,	22,	28],
[27,	21,	15,	10,	 6,	 3,	 1,	 0,	 1,	 3,	6,	10,	15,	21,	27],
[28,	22,	16,	11,	 7,	 4,	 2,	 1,	 2,	 4,	7,	11,	16,	22,	28],
[29,	23,	17,	12,	 8,	 5,	 4,	 3,	 4,	 5,	8,	12,	17,	23,	29],
[30,	24,	18,	13,	 9,	 8,	 7,	 6,	 7,	 8,	9,	13,	18,	24,	30],
[-1,	25,	19,	14,	13,	12,	11,	10,	11,	12,	13,	14,	19,	25,	-1],
[-1,	26,	20,	19,	18,	17,	16,	15,	16,	17,	18,	19,	20,	26,	-1],
[-1,	-1,	26,	25,	24,	23,	22,	21,	22,	23,	24,	25,	26,	-1,	-1],
[-1,	-1,	-1,	-1,	30,	29,	28,	27,	28,	29,	30,	-1,	-1,	-1,	-1],